JLWWWWWWW
JLJLFFFFF
JLJWWWJLJ
JFFFFFFLJ
JLWWWWJLJ