FFFFFFFFF
WWWWWWWWW
FFFFFFFFF
JLJLJLJLJ
FFFFFFFFF